111111111111111111111111111111
1E0000000000000C00C00000000001
101001010010000010100001000001
100000000C00C00000000X00C00001
100000000C00C00000000000C00001
1P0000000C00C00000000000C00001
111111111111111111111111111111